##########
#..E.....######
#..#..!.......#
#.............#
#####.....#######
    #.....#..P..#
    #.....#.....#
    #.....#.....#
    #...........#
    #############